111111111111
1001000C1001
1000PC100001
10C1C01E10C1
111111111111
