111111111111
1001000C1001
1001PC100001
10C0C01E10C1
111111111111
