111111111111111111111111111111
100000010001C0101010C1001CC1C1
10C1P1C1C001CC00101000001C0101
1E0101C1011101101010C110101101
110111110000001C0C101100000101
100100C0CC01111100000100100101
1001CC011101C0000C110101111101
11011011C00111101110010C100101
1C000CC100010000C010010000C001
111111111111111111111111111111
