1111111111111111111111111111111
100C1E01C010000001CC10010000101
1000100000000010010C10C100101C1
1011111101111110110C1011101C001
100010010001001C010110000010101
111010C1000100100100110111101C1
1C0000C101110C11010110C00010101
100011C00CC1101000000P111111101
1101100000C10010110010000CC1001
100011101111101C010110001C01001
10C01CC0C00000100100100C1C00001
1111111111111111111111111111111
